R 1920 1040
NO ./textures/colorstone.xpm
SO ./textures/mossy.xpm 
WE ./textures/imgp5514_seamless_2.xpm
EA ./textures/rockfloorbig.xpm
S ./textures/barrel.xpm
C 102,178,255
F 51,51,4




        1111111111111111111111111
        1000000000110000000000001
        1011000001110000002020201
        1001000000000000002020201
111111111011000001110000000020201
100000000011000001110111110111111
11110111111111011100000010001       11111111111111111
11110111111111011101010010001       10000000000000001
11000000110101011100000010001       10000000000000001
10000000000000001100000010001111111110000000000200001
10000000000000001101010010000000000000000000000000001
11000001110101011111011110001111111110000000000000001
11110111 1110101 101111010001       10000000000000001
11111111 1111111 111111111101       10000000000000001
                          101       11111111111111111
                          101
     1111111111111111111111011111111111111111111111
     1000000000000000000000000000000000000000000001
     1000000000000000000000000000000000000000000001
     1000000000000000000000000000000000000000000001
     1000000000000000000000000000000000000000000001
     1000000000000000000000000000000000000000000001
     10000000000000000000000000000000000000000000W1
     1222222222222222222222222222222222222222222221
     1111111111111111111111111111111111111111111111
